丹尼斯· 约翰逊	丹尼斯·约翰逊
爱德华 ·肯尼迪	爱德华·肯尼迪
王昭异	王昭 异
2013万 思维	2013 万思维
刘兴子	刘兴 子
卢郁文率	卢郁文 率
李歆派	李歆 派
孙权率	孙权 率
佩贾·斯托 贾科维奇	佩贾·斯托贾科维奇
克利 奥帕特拉七世	克利奥帕特拉七世
孙策率	孙策 率
邓 浩洪	邓浩洪
蔡翘堂 侄蔡纪辕	蔡翘 堂侄 蔡纪辕
伊丽莎白 · 泰勒	伊丽莎白·泰勒
A n g e l a b a b y	Angelababy
卢娜·洛夫 古德	卢娜·洛夫古德
刘协禅 让	刘协 禅让
胡安 · 卡洛斯一世	胡安·卡洛斯一世
劳尔·卡斯特 罗	劳尔·卡斯特罗
刘恢异 母兄	刘恢 异母兄
M · 凯撒·库朗	M·凯撒·库朗
陈德擒 获	陈德 擒获
巴西 勒·阿萨德	巴西勒·阿萨德
K · C · 琼斯	K·C·琼斯
李 于 磨属	李于磨 属
刘交派 其子	刘交 派 其子
卡梅隆· 道格拉斯	卡梅隆·道格拉斯
佩内 洛普·克鲁兹	佩内洛普·克鲁兹
卢镗亲率	卢镗 亲率
1志 田达哉	1 志田达哉
加尔比妮·穆古拉 扎	加尔比妮·穆古拉扎
刘开子 刘翼	刘开 子 刘翼
严嵩子 严世蕃	严嵩 子 严世蕃
禹是 黄帝	禹 是 黄帝
他 信·西那 瓦	他信·西那瓦
李雄派 中 领军	李雄 派 中领军
乔治 · 华盛顿	乔治·华盛顿
尹峻相0	尹峻相 0
王蔷7	王蔷 7
周瑜率	周瑜 率
朵噶·彭措 饶杰 主持	朵噶·彭措饶杰 主持
凯瑟琳·泽塔 - 琼斯	凯瑟琳·泽塔-琼斯
何启偕 新婚	何启 偕 新婚
维多利亚 女王	维多利亚女王
丘濬处 了解	丘濬 处 了解
以 赛亚·考辛斯	以赛亚·考辛斯
A v i c i i	Avicii
克利 奥帕特拉七世	克利奥帕特拉七世
阿图尔·鲁宾 斯坦	阿图尔·鲁宾斯坦
金与 正是	金与正 是
路德维希·维特 根斯坦	路德维希·维特根斯坦
林丹0	林丹 0
胡安 · 卡洛斯一世	胡安·卡洛斯一世
奏 任何 嗣焜	奏任 何嗣焜
李雄派	李雄 派
李恪九 世孙	李恪 九 世孙
何伟学 赵丽蓉	何伟 学 赵丽蓉
卡隆· 巴特勒	卡隆·巴特勒
伊丽莎白 二 世	伊丽莎白二世
李暠六 世孙	李暠 六世孙
凯文 - 普林斯·博阿滕	凯文-普林斯·博阿滕
